####################
#                  #
#                  #
#                 E#
#                  #
#                  #
#                  #
#  S               #
#                  #
####################
---
####################
#SE                #
#                  #
#                  #
#                  #
#                  #
#                  #
#                  #
#                  #
####################
