####################
#                  #
#                  #
#     ##    #     E#
#      # ## #      #
#      # #  #      #
#          #       #
#  S               #
#                  #
####################
---
####################
#SE                #
#                  #
#                  #
#                  #
#                  #
#                  #
#                  #
#                  #
####################
