#                  #
#                  #
#                  #
#                  #
#                  #
#                  #
#                  #
#                  #
#                  #
####################
---
####################
#SE                #
#                  #
#                  #
#                  #
#                  #
#                  #
#                  #
#                  #
####################
